0111111111
1000000001
1000000001
1000100001
1000000001
100000P001
1001000001
1000000001
1001000001
1111111111
