NO xpm_files/wood.xpm
SO xpm_files/wood.xpm











EA xpm_files/mossy.xpm
WE xpm_files/door.xpm





11111111111111111111111111111111111
1P000000000000000000000000000000001
10001110001110001110001110000000001
10000000000000000000000000000000001
10000000011100011100011100000000001
10000000000000000000000000000000001
10000001110001110001110000000000001
10000000000000000000000000000000001
10000000000000000000000000000000001
10000000011100011100011100000000001
10000000000000000000000000000000001
10000001110001110001110000000000001
10000000000000000000000000000000001
10000000000000000000000000000000001
10000000011100011100011100000000001
10000000000000000000000000000000001
10000001110001110001110000000000001
10000000000000000000000000000000001
10000000000000000000000000000000001
10000000011100011100011100000000001
10000000000000000000000000000000001
10000001110001110001110000000000001
10000000000000000000000000000000001
10000000000000000000000000000000001
10000000011100011100011100000000001
10000000000000000000000000000000001
10000001110001110001110000000000001
10000000000000000000000000000000001
10000000000000000000000000000000001
10000000011100011100011100000000001
10000000000000000000000000000000001
10000001110001110001110000000000001
10000000000000000000000000000000001
10000000000000000000000000000000001
11111111111111111111111111111111111
