    WE ./textures/color_stone.xpm
    EA ./textures/red_brick.xpm
    NO ./textures/wood.xpm    
    SO ./textures/grey_stone.xpm
    F    255 ,      165     ,     77                               
    C    130   ,   200    ,    229      
    111111
    100101
    101001
    11N001
    111111