 DO textures/door.xpm

F 0, 94, 0

C 4, 4, 68
NO textures/brick.xpm
SO textures/wood.xpm
EA textures/red_brick.xpm
WE textures/blue_stone.xpm
11111111111111111111111111111111111111111111
1000000000000000000000010000000000000000000D1                    
100000D00000000010000D00000000001111111111111111        
1000010000000001N000011111D111D000000000000000001111111
100000000100000010000D000000000011111111111111111
10000000000000000000000100000000001
11111111111111111111111111111111111
