NO textures/eagle.xpm
SO textures/wood.xpm
EA textures/red_brick.xpm
WE textures/blue_stone.xpm 
DO textures/door.xpm

C 0, 0, 255
F 0, 255, 0

11111111111111111111111111111111111
10000000000000000100000100000000001 
10000000010100000D10000D00000000001
1000000001D100000DN000011111D111D11
10000000010100000000000D00000000001
10000000000000000000000100000000001
11111111111111111111111111111111111