NO xpm_files/eagle.xpm
SO xpm_files/wood.xpm
EA xpm_files/mossy.xpm
WE xpm_files/blue_stone.xpm
DO xpm_files/door.xpm


DDDDDDDDDDDDDDDDDDDDDDDDDDDDDDDDDDD
10000000000000000000000000000000001
1000D110001110001110001110000000001
10P00000000000000000000000000000001
10000000011100011100011100000000001
10000000000000000000000000000000001
10000001110001110001110000000000001
10000000000000000000000000000000001
10000000000000000000000000000000001
10000000011100011100011100000000001
10000000000000000000000000000000001
10000001110001110001110000000000001
10000000000000000000000000000000001
10000000000000000000000000000000001
10000000011100011100011100000000001
10000000000000000000000000000000001
10000001110001110001110000000000001
10000000000000000000000000000000001
10000000000000000000000000000000001
10000000011100011100011100000000001
10000000000000000000000000000000001
10000001110001110001110000000000001
10000000000000000000000000000000001
10000000000000000000000000000000001
10000000011100011100011100000000001
10000000000000000000000000000000001
10000001110001110001110000000000001
10000000000000000000000000000000001
10000000000000000000000000000000001
10000000011100011100011100000000001
10000000000000000000000000000000001
10000001110001110001110000000000001
10000000000000000000000000000000001
10000000000000000000000000000000001
11111111111111111111111111111111111
