NO xpm_files/eagle.xpm
SO xpm_files/wood.xpm
EA xpm_files/mossy.xpm
WE xpm_files/blue_stone.xpm
DO xpm_files/door.xpm


11111111111111111111111111111111111
10000000000000000000000100000000001
10000000000000000000000D00000000001
100000P000000000000000011111D111D11
10000000000000000000000D00000000001
10000000000000000000000100000000001
11111111111111111111111111111111111
