 DO textures/door.xpm

F 0, 94, 0

C 4, 4, 68
NO textures/brick.xpm
SO textures/wood.xpm
EA textures/red_brick.xpm
WE textures/blue_stone.xpm

1111111111111111111111111111111111111111111111111
100000000D000000000000010000000000000000000111111                
1001111D11110110010001D000000000011111111D1111111111111       
1000010000000D00N000011111D11D100000000000000000D000011
100000000100010010000D00000000111D111111111111111111111
10000000000000000000010000001100001111
111111111111111111111111111111111111111