
NO textures/brick.xpm
SO textures/wood.xpm
EA textures/red_brick.xpm
WE textures/blue_stone.xpm

F 0, 94, 0

C 4, 4, 68


11111111111111111111111111111111111111111111
100000000000000000000001000000000000000000011                    
100000100000000010000100000000001111111111111111        
1000010000000001N00001111111111000000000000000001111111
1000000001000000100001000000000011111111111111111
10000000000000000000000100000000001
11111111111111111111111111111111111
