NO ./xpm_files/eagle.xpm
SO ./xpm_files/wood.xpm











EA ./xpm_files/mossy.xpm
WE ./xpm_files/blue_stone.xpm


11111111111111111111111111111111111
10000000000000000000000000000000001
100000000000000000000000000000000W1
11111111111111111111111111111111111
