NO xpm_files/eagle.xpm
SO xpm_files/wood.xpm











EA xpm_files/mossy.xpm
WE xpm_files/blue_stone.xpm



11111111111111111111111111111111111
11000000000000000001110000000000101
10001110001110001111111110000000111
10000000000000000000000000000000001
10000000011100011100011100000000001
10000000000000000000000000000000001
10000001110001110001110000000000001
10000000000000000000000000000000001
10000000000000000000000000000000001
10000000011100011100011100000000001
10000000000000000000000000000000001
10000001110001110001110000000000001
10000000000000000000000000000000001
10000000000000000000000000000000001
10000000011100011100011100000000001
10000000000000000000000000000000001
10000001110001110001110000000000001
10000000000000000000000000000000001
10000000000000000000000000000000001
10000000011100011100011100000000001
10000000000000000000000000000000001
10000001110001110001110000000000001
10000000000000000000000000000000001
10000000000000000000000000000000001
10000000011100011100011100000000001
10000000000000000000000000000000001
10000001110001110001110000000000001
10000000000000000000000000000000001
10000000000000000000000000000000001
10000000011100011100011100000000001
10000000000000000000000000000000001
10000001110001110001110000000000001
10000000000000000000000000000000001
1W000000000000000000000000000000001
11111111111111111111111111111111111
