NO ./xpm_files/eagle.xpm
SO ./xpm_files/wood.xpm











EA ./xpm_files/mossy.xpm
WE ./xpm_files/blue_stone.xpm


   111     11   1111111
 1111 111111111111111111
1010110000100000000000001
1000110000000000111111001
100000000S000000110001001
1000000000100000000001001
 11111111111111111111111
     1
   1
     1
 111
111
11
