NO ./xpm_files/eagle.xpm
SO ./xpm_files/wood.xpm











EA ./xpm_files/mossy.xpm
WE ./xpm_files/blue_stone.xpm

C 218, 234, 235
F      17,    38,     64

1111111111111111111111111111111111111111111111111111111111111111
1000000000000000000000000000000000000000000000000000000000000001
1000000000000000000000000000000000000000000000000000000000000001
1000000000000000000000000000000000000000000000000000000000000001
100000000000000000000000000000000N000000000000000000000000000001
1000000000000000000000000000000000000000000000000000000000000001
1000000000000000000000000000000000000000000000000000000000000001
1000000000000000000000000000000000000000000000000000000000000001
1111111111111111111111111111111111111111111111111111111111111111
