C 130,200,229







F 255,165,0




NO ./textures/wood.xpm











SO ./textures/grey_stone.xpm
EA ./textures/red_brick.xpm




WE ./textures/color_stone.xpm
111111
1000001
111111
111111
100N01
111111
111111
111111