C 130,200,229
F 255,165,0

NO ./textures/brick.xpm
SO ./textures/brick.xpm
EA ./textures/brick.xpm
WE ./textures/brick.xpm

11111111111111111111111111111111
10000010111111111111111011111011
10000110111111111000000000000101
100000000001000000000000000001011
100000000111111111111111111001111
100N0000000011111111111111110101
1000000000010111111111111111011
100000000000000000000000000001
111111111111111111111111111111