
NO textures/brick.xpm
SO textures/wood.xpm
EA textures/red_brick.xpm
WE textures/blue_stone.xpm

F 0, 94, 0

C 4, 4, 68


11111111111111111111111111111111111111111111
100000000000000000000001000000000000000000011                    
100000100000000000000101000000000000000000001111111        
1000010000000001N0000111000000000000000001111111
1000000001000000100001000000000011111111111111111
1000000000000000000000000000000000000000011111111
1000000000000000000000000000000000000000011111111
1000000000000000000100000000000000000000011111111
1000000000000000000100000000001000000000011111111
1000000000000000000010111000001000000000011111111
1000000000000000000000000000001000000000011111111
1000000000000000000000000000000000000000011111111
1011111100000000000000000000000000000000011111111
1000000000000000000000000000000000000000011111111
1000000000000000000000010000000000000000011111111
1000000000000000000000010000000000000000011111111
10000000000000000000000100000000001111111
11111111111111111111111111111111111
